British Virgin Is.
Baker I.
Gaza Strip
Glorioso Is.
Howland I.
Jan Mayen
Jarvis I.
Johnston Atoll
Juan De Nova I.
Midway Is.
Paracel Is.
Spratly Is.
St. Kitts  Nevis
St. Lucia
St. Vincent  the Grenadines
Wake I.
West Bank


Afghanistan|Afghanistan|Afghanistan|Afghanestan
Albania|Albania|Albanien|Shqiperia
Algeria|Algeria|Algerien|Al Jaza'ir
American Samoa|American Samoa|Amerikanisch-Samoa|American Samoa
Andorra|Andorra|Andorra|Andorra
Angola|Angola|Angola|Angola
Anguilla|Anguilla|Anguilla|Anguilla
Antarctica|Antarctica|Antarktis|Antarctica
Antigua  Barbuda|Antigua and Barbuda|Antigua und Barbuda|Antigua and Barbuda
Argentina|Argentina|Argentinien|Argentina
Armenia|Armenia|Armenien|Hayastan
Aruba|Aruba|Aruba|Aruba
Ascension|Ascension|Ascension|Ascension
Australia|Australia|Australien|Australia
Austria|Austria|Österreich|Österreich
Azerbaijan|Azerbaijan|Aserbaidschan|Azarbaycan
The Bahamas|Bahamas|Bahamas|Bahamas
Bahrain|Bahrain|Bahrain|Al Bahrayn
Bangladesh|Bangladesh|Bangladesch|Bangladesh
Barbados|Barbados|Barbados|Barbados
Belarus|Belarus|Belarus, (Weißrußland)|Byelarus
Belgium|Belgium|Belgien|Belgique/Belgie
Belize|Belize|Belize|Belize
Benin|Benin|Benin|Benin
Bermuda|Bermuda|Bermuda|Bermuda
Bhutan|Bhutan|Bhutan|Bhutan
Bolivia|Bolivia|Bolivien|Bolivia
Bosnia  Herzegovina|Bosnia and Herzegovina|Bosnien und Herzegovina|Bosna i Hercegovina
Botswana|Botswana|Botsuana|Botswana
Bouvet I.|Bouvet Island|Bouvetinsel|Bouvet Island
Brazil|Brazil|Brasilien|Brasil
British Indian Ocean Territory|British Indian Ocean Territory|Britisches Territorium im Indischen Ozean|British Indian Ocean Territory
Brunei|Brunei Darussalam|Brunei Darussalam|Negara Brunei Darussalam
Bulgaria|Bulgaria|Bulgarien|Bulgaria
Burkina Faso|Burkina Faso|Burkina Faso (Obervolta - 1984)|Burkina Faso
Burundi|Burundi|Burundi|Burundi
Cambodia|Cambodia|Kambodscha|Kampuchea
Cameroon|Cameroon|Kamerun|Cameroon
Canada|Canada|Kanada|Canada
Cape Verde|Cape Verde|Kap Verde|Cabo Verde
Cayman Is.|Cayman Islands|Kaimaninseln|Cayman Islands
Central African Republic|Central African Republic|Zentralafrikanische Republik|Republique Centrafricaine
Chad|Chad|Tschad|Tchad
Chile|Chile|Chile|Chile
China|China|China|Zhong Guo
Christmas I.|Christmas Island|Weihnachtsinsel|Christmas Island
Cocos Is.|Cocos (Keeling) Islands|Kokosinseln (Keeling)|Cocos (Keeling) Islands
Colombia|Colombia|Kolumbien|Colombia
Comoros|Comoros|Komoren|Comores
Congo, DRC|Democratic Republic of the Congo (Kinshasa)|Kongo, Demokratische Republik|République Démocratique du Congo
Congo|Congo, Republic of (Brazzaville)|Kongo|République du Congo
Cook Is.|Cook Islands|Cookinseln|Cook Islands
Costa Rica|Costa Rica|Costa Rica|Costa Rica
Cote d'Ivory|Ivory Coast|Côte d'Ivoire (Elfenbeinküste)|Cote d'Ivoire
Croatia|Croatia|Kroatien|Hrvatska
Cuba|Cuba|Kuba|Cuba
Cyprus|Cyprus|Zypern|Kibris/Kypros
Czech Republic|Czech Republic|Tschechische Republik|Ceska Republika
Denmark|Denmark|Dänemark|Danmark
Djibouti|Djibouti|Dschibuti|Djibouti
Dominica|Dominica|Dominica|Dominica
Dominican Republic|Dominican Republic|Dominikanische Republik (Dom Rep)|Dominicana, Republica
East Timor Timor-Leste|East Timor Timor-Leste|Timor-Leste (Osttimor)|Timor
Ecuador|Ecuador|Ecuador|Ecuador
Egypt|Egypt|Ägypten|Misr
El Salvador|El Salvador|El Salvador|El Salvador
Equatorial Guinea|Equatorial Guinea|Äquatorialguinea|Guinea Ecuatorial
Eritrea|Eritrea|Eritrea|Hagere Ertra
Estonia|Estonia|Estland|Eesti Vabariik
Ethiopia|Ethiopia|Äthiopien|Ityop'iya
Falkland Is.|Falkland Islands|Falklandinseln (Malvinen)|Islas Malvinas
Faroe Is.|Faroe Islands|Färöer|Foroyar
Fiji|Fiji|Fidschi|Fiji
Finland|Finland|Finnland|Suomen Tasavalta
France|France|Frankreich|France
French Guiana|French Guiana|Französisch-Guayana|Guyane
French Metropolitan|French Metropolitan|--|France Métropolitaine
French Polynesia|French Polynesia|Französisch-Polynesien|Polynésie Française
French Southern  Antarctic Lands|French Southern Territories|Französische Süd- und Antarktisgebiete|Terres Australes et Antarctiques Françaises
Gabon|Gabon|Gabun|Gabon
The Gambia|Gambia|Gambia|The Gambia
Georgia|Georgia|Georgien|Sak'art'velo
Germany|Germany|Deutschland|Deutschland
Ghana|Ghana|Ghana|Ghana
Gibraltar|Gibraltar|Gibraltar|Gibraltar
Great Britain|Great Britain|Großbritannien|Great Britain
Greece|Greece|Griechenland|Ellas or Ellada
Greenland|Greenland|Grönland|Kalaallit Nunaat
Grenada|Grenada|Grenada|Grenada
Guadeloupe|Guadeloupe|Guadeloupe|Guadeloupe
Guam|Guam|Guam|Guam
Guatemala|Guatemala|Guatemala|Guatemala
Guernsey|Guernsey|Guernsey|Guernsey
Guinea|Guinea|Guinea|Guinee
Guinea-Bissau|Guinea-Bissau|Guinea-Bissau|Guine-Bissau
Guyana|Guyana|Guyana|Guyana
Haiti|Haiti|Haiti|Haiti
Heard I.  McDonald Is.|Heard and Mc Donald Islands|Heard und die Mcdonaldinseln|Heard and Mc Donald
Holy See|Holy See|Heiliger Stuhl (Vatikanstadt)|Status Civitatis Vaticanæ
Honduras|Honduras|Honduras|Honduras
Hong Kong|Hong Kong|Hongkong|Xianggang
Hungary|Hungary|Ungarn|Magyarorszag
Iceland|Iceland|Island|Lyoveldio Island
India|India|Indien|Bharat
Indonesia|Indonesia|Indonesien|Indonesia
Iran|Iran (Islamic Republic of)|Iran, Islamische Republik|Iran
Iraq|Iraq|Irak|Iraq
Ireland|Ireland|Irland|Éire
Isle of Man|Isle of Man|Insel Man|Isle of Man
Israel|Israel|Israel|Yisra'el
Italy|Italy|Italien|Italia
Jamaica|Jamaica|Jamaika|Jamaica
Japan|Japan|Japan|Nippon/Nihon
Jersey|Jersey|Jersey|Jersey
Jordan|Jordan|Jordanien|Al Urdun
Kazakhstan|Kazakhstan|Kasachstan|Qazaqstan
Kenya|Kenya|Kenya|Kenya
Kiribati|Kiribati|Kiribati|Kiribati, (Kiribas)
North Korea|Korea, Democratic People's Rep. (North Korea)|Korea, Demokratische Volksrepublik (Nord Korea)|Choson
South Korea|Korea, Republic of (South Korea)|Korea, Republik (Süd Korea)|Han-guk
Kuwait|Kuwait|Kuwait|Al Kuwayt
Kyrgyzstan|Kyrgyzstan|Kirgisistan|Kyrgyz Respublikasy
Laos|Lao, People's Democratic Republic|Laos, Demokratische Volksrepublik|Lao
Latvia|Latvia|Lettland|Latvija
Lebanon|Lebanon|Libanon|Lubnan
Lesotho|Lesotho|Lesotho|Lesotho
Liberia|Liberia|Liberia|Liberia
Libya|Libya|Libyen, Libysch-Arabische Dschamahirija|Libiyah
Liechtenstein|Liechtenstein|Liechtenstein|Liechtenstein
Lithuania|Lithuania|Litauen|Lietuva
Luxembourg|Luxembourg|Luxemburg|Luxembourg, Letzebuerg
Macao|Macao|Macau|Aomen
Macedonia|Macedonia, Rep. of|Mazedonien|Makedonija
Madagascar|Madagascar|Madagaskar|Madagascar
Malawi|Malawi|Malawi|Malawi
Malaysia|Malaysia|Malaysia|Malaysia
Maldives|Maldives|Malediven|Dhivehi Raajje
Mali|Mali|Mali|Mali
Malta|Malta|Malta|Malta
Marshall Is.|Marshall Islands|Marshallinseln|Marshall Islands
Martinique|Martinique|Martinique|Martinique
Mauritania|Mauritania|Mauretanien|Muritaniyah
Mauritius|Mauritius|Mauritius|Mauritius
Mayotte|Mayotte|Mayotte|Mayotte
Mexico|Mexico|Mexiko|Estados Unidos Mexicanos
Micronesia|Micronesia, Federal States of|Mikronesien, Föderierte Staaten von|Micronesia
Moldova|Moldova, Republic of|Moldau, Republik|Moldova
Monaco|Monaco|Monaco|Monaco
Serbia  Montenegro|Montenegro|Montenegro|Crna Gora
Mongolia|Mongolia|Mongolei|Mongol Uls
Montserrat|Montserrat|Montserrat|Montserrat
Morocco|Morocco|Marokko|Al Maghrib
Mozambique|Mozambique|Mosambik|Mocambique
Myanmar|Myanmar, Burma|Myanmar, Birma|Myanma Naingngandaw
Namibia|Namibia|Namibia|Namibia
Nauru|Nauru|Nauru|Nauru
Nepal|Nepal|Nepal|Nepal
Netherlands|Netherlands|Niederlande|Nederland
Netherlands Antilles|Netherlands Antilles|Niederländische Antillen|Nederlandse Antillen
New Caledonia|New Caledonia|Neukaledonien|Nouvelle-Calédonie
New Zealand|New Zealand|Neuseeland|Aotearoa
Nicaragua|Nicaragua|Nicaragua|Nicaragua
Niger|Niger|Niger|Niger
Nigeria|Nigeria|Nigeria|Nigeria
Niue|Niue|Niue|Niue
Norfolk I.|Norfolk Island|Norfolkinsel|Norfolk Island
Northern Mariana Is.|Northern Mariana Islands|Marianen, Nördliche|Northern Mariana Islands
Norway|Norway|Norwegen|Norge
Oman|Oman|Oman|Saltanat Uman
Pakistan|Pakistan|Pakistan|Pakistan
Palau|Palau|Palau|Belau
Palestinian National Authority|Palestinian National Authority|Palästinensische Autonomiegebiete|Filastin
Panama|Panama|Panama|Panama
Papua New Guinea|Papua New Guinea|Papua-Neuguinea|Papua Niu Gini
Paraguay|Paraguay|Paraguay|Paraguay
Peru|Peru|Peru|Peru
Philippines|Philippines|Philippinen|Pilipinas
Pitcairn Is.|Pitcairn Island|Pitcairninseln|Pitcairn Island
Poland|Poland|Polen|Polska
Portugal|Portugal|Portugal|Portugal
Puerto Rico|Puerto Rico|Puerto Rico|Puerto Rico
Qatar|Qatar|Katar|Dawlat Qatar
Reunion|Reunion Island|Réunion|Ile de la Réunion
Romania|Romania|Rumänien|Romania
Russia|Russian Federation|Russische Föderation (Russland)|Rossiya
Rwanda|Rwanda|Ruanda|Rwanda
Saint Kitts and Nevis|Saint Kitts and Nevis|St. Kitts und Nevis| 
Saint Lucia|Saint Lucia|St. Lucia|Saint Lucia
Saint Vincent and the Grenadines|Saint Vincent and the Grenadines|St. Vincent und die Grenadinen| 
Samoa|Samoa|Samoa|Samoa
San Marino|San Marino|San Marino|San Marino
Sao Tome  Principe|Sao Tome and Príncipe|São Tomé und Príncipe|Sao Tome e Principe
Saudi Arabia|Saudi Arabia|Saudi-Arabien|Al Arabiyah as Suudiyah
Senegal|Senegal|Senegal|Senegal
Serbia|Serbia|Serbien|Srbija
Seychelles|Seychelles|Seychellen|Seychelles
Sierra Leone|Sierra Leone|Sierra Leone|Sierra Leone
Singapore|Singapore|Singapur|Singapore
Slovakia|Slovakia (Slovak Republic)|Slowakei|Slovensko
Slovenia|Slovenia|Slowenien|Slovenija
Solomon Is.|Solomon Islands|Salomonen|Solomon Islands
Somalia|Somalia|Somalia|Somalia
South Africa|South Africa|Südafrika|South Africa
South Georgia  the South Sandwich Is.|South Georgia and South Sandwich Islands|Südgeorgien und die südlichen Sandwichinseln| 
Spain|Spain|Spanien|España
Sri Lanka|Sri Lanka|Sri Lanka|Sri Lanka
St. Helena|Saint Helena|St. Helena|Saint Helena
St. Pierre  Miquelon|St. Pierre and Miquelon|St. Pierre und Miquelon|Saint-Pierre et Miquelon
Sudan|Sudan|Sudan|As-Sudan
Suriname|Suriname|Suriname|Suriname
Svalbard|Svalbard and Jan Mayen Islands|Svalbard und Jan Mayen|Spitzbergen
Swaziland|Swaziland|Swasiland|Swaziland
Sweden|Sweden|Schweden|Sverige
Switzerland|Switzerland|Schweiz|Schweiz (German), Suisse (French), Svizzera (Italian)
Syria|Syria, Syrian Arab Republic|Syrien, Arabische Republik|Suriyah
Taiwan, Republic of China|Taiwan, Republic of China|Taiwan|T'ai-wan
Tajikistan|Tajikistan|Tadschikistan|Jumhurii Tojikiston
Tanzania|Tanzania|Tansania, Vereinigte Republik|Tanzania
Thailand|Thailand|Thailand|Prathet Thai
Tibet|Tibet|Tibet|Bod
Timor Leste|Timor-Leste (East Timor)|Timor-Leste (Osttimor)|Timor
Togo|Togo|Togo|Republique Togolaise
Tokelau|Tokelau|Tokelau|Tokelau
Tonga|Tonga|Tonga|Tonga
Trinidad  Tobago|Trinidad and Tobago|Trinidad und Tobago|Trinidad, Tobago
Tunisia|Tunisia|Tunesien|Tunis
Turkey|Turkey|Türkei|Turkiye
Turkmenistan|Turkmenistan|Turkmenistan|Turkmenistan
Turks  Caicos Is.|Turks and Caicos Islands|Turks- und Caicosinseln|Turks and Caicos Islands
Tuvalu|Tuvalu|Tuvalu|Tuvalu
Uganda|Uganda|Uganda|Uganda
Ukraine|Ukraine|Ukraine|Ukrayina
United Arab Emirates|United Arab Emirates|Vereinigte Arabische Emirate|Al Imarat al Arabiyah al Muttahidah
United Kingdom|United Kingdom|Vereinigtes Königreich|United Kingdom
United States|United States|Vereinigte Staaten|United States
U.S. Minor Outlying Islands|U.S. Minor Outlying Islands|Amerikanische Überseeinseln, Kleinere|U.S. Minor Outlying Islands
Uruguay|Uruguay|Uruguay|Republica Oriental del Uruguay
Uzbekistan|Uzbekistan|Usbekistan|Uzbekiston Respublikasi
Vanuatu|Vanuatu|Vanuatu|Vanuatu
Vatican City|Vatican City State (Holy See)|Heiliger Stuhl (Vatikanstadt)|Status Civitatis Vaticanæ
Venezuela|Venezuela|Venezuela|Venezuela
Vietnam|Vietnam|Vietnam|Viet Nam
Virgin Is.|Virgin Islands (British)|Britische Jungferninseln| 
Virgin Islands (U.S.)|Virgin Islands (U.S.)|Amerikanische Jungferninseln|Virgin Islands
Wallis  Futuna|Wallis and Futuna Islands|Wallis und Futuna|Wallis et Futuna
Western Sahara|Western Sahara|Westsahara
Yemen|Yemen|Jemen|Al Yaman
Zaire (see Congo, Democratic People's Republic)|Zaire (see Congo, Democratic People's Republic)|Zaire|Zaire
Zambia|Zambia|Sambia|Zambia
Zimbabwe|Zimbabwe|Simbabwe|Zimbabwe