Afghanistan|Afghanistan|Afghanestan
Albania|Albanien|Shqiperia
Algeria|Algerien|Al Jaza'ir
American Samoa|Amerikanisch-Samoa|American Samoa
Andorra|Andorra|Andorra
Angola|Angola|Angola
Anguilla|Anguilla|Anguilla
Antarctica|Antarktis|Antarctica
Antigua and Barbuda|Antigua und Barbuda|Antigua and Barbuda
Argentina|Argentinien|Argentina
Armenia|Armenien|Hayastan
Aruba|Aruba|Aruba
Ascension|Ascension|Ascension
Australia|Australien|Australia
Austria|Österreich|Österreich
Azerbaijan|Aserbaidschan|Azarbaycan
Bahamas|Bahamas|Bahamas
Bahrain|Bahrain|Al Bahrayn
Bangladesh|Bangladesch|Bangladesh
Barbados|Barbados|Barbados
Belarus|Belarus, (Weißrußland)|Byelarus
Belgium|Belgien|Belgique/Belgie
Belize|Belize|Belize
Benin|Benin|Benin
Bermuda|Bermuda|Bermuda
Bhutan|Bhutan|Bhutan
Bolivia|Bolivien|Bolivia
Bosnia and Herzegovina|Bosnien und Herzegovina|Bosna i Hercegovina
Botswana|Botsuana|Botswana
Bouvet Island|Bouvetinsel|Bouvet Island
Brazil|Brasilien|Brasil
British Indian Ocean Territory|Britisches Territorium im Indischen Ozean|British Indian Ocean Territory
Brunei Darussalam|Brunei Darussalam|Negara Brunei Darussalam
Bulgaria|Bulgarien|Bulgaria
Burkina Faso|Burkina Faso (Obervolta - 1984)|Burkina Faso
Burundi|Burundi|Burundi
Cambodia|Kambodscha|Kampuchea
Cameroon|Kamerun|Cameroon
Canada|Kanada|Canada
Cape Verde|Kap Verde|Cabo Verde
Cayman Islands|Kaimaninseln|Cayman Islands
Central African Republic|Zentralafrikanische Republik|Republique Centrafricaine
Chad|Tschad|Tchad
Chile|Chile|Chile
China|China|Zhong Guo
Christmas Island|Weihnachtsinsel|Christmas Island
Cocos (Keeling) Islands|Kokosinseln (Keeling)|Cocos (Keeling) Islands
Colombia|Kolumbien|Colombia
Comoros|Komoren|Comores
Democratic Republic of the Congo (Kinshasa)|Kongo, Demokratische Republik|République Démocratique du Congo
Congo, Republic of (Brazzaville)|Kongo|République du Congo
Cook Islands|Cookinseln|Cook Islands
Costa Rica|Costa Rica|Costa Rica
Ivory Coast|Côte d'Ivoire (Elfenbeinküste)|Cote d'Ivoire
Croatia|Kroatien|Hrvatska
Cuba|Kuba|Cuba
Cyprus|Zypern|Kibris/Kypros
Czech Republic|Tschechische Republik|Ceska Republika
Denmark|Dänemark|Danmark
Djibouti|Dschibuti|Djibouti
Dominica|Dominica|Dominica
Dominican Republic|Dominikanische Republik (Dom Rep)|Dominicana, Republica
East Timor Timor-Leste|Timor-Leste (Osttimor)|Timor
Ecuador|Ecuador|Ecuador
Egypt|Ägypten|Misr
El Salvador|El Salvador|El Salvador
Equatorial Guinea|Äquatorialguinea|Guinea Ecuatorial
Eritrea|Eritrea|Hagere Ertra
Estonia|Estland|Eesti Vabariik
Ethiopia|Äthiopien|Ityop'iya
Falkland Islands|Falklandinseln (Malvinen)|Islas Malvinas
Faroe Islands|Färöer|Foroyar
Fiji|Fidschi|Fiji
Finland|Finnland|Suomen Tasavalta
France|Frankreich|France
French Guiana|Französisch-Guayana|Guyane
French Metropolitan|--|France Métropolitaine
French Polynesia|Französisch-Polynesien|Polynésie Française
French Southern Territories|Französische Süd- und Antarktisgebiete|Terres Australes et Antarctiques Françaises
Gabon|Gabun|Gabon
Gambia|Gambia|The Gambia
Georgia|Georgien|Sak'art'velo
Germany|Deutschland|Deutschland
Ghana|Ghana|Ghana
Gibraltar|Gibraltar|Gibraltar
Great Britain|Großbritannien|Great Britain
Greece|Griechenland|Ellas or Ellada
Greenland|Grönland|Kalaallit Nunaat
Grenada|Grenada|Grenada
Guadeloupe|Guadeloupe|Guadeloupe
Guam|Guam|Guam
Guatemala|Guatemala|Guatemala
Guernsey|Guernsey|Guernsey
Guinea|Guinea|Guinee
Guinea-Bissau|Guinea-Bissau|Guine-Bissau
Guyana|Guyana|Guyana
Haiti|Haiti|Haiti
Heard and Mc Donald Islands|Heard und die Mcdonaldinseln|Heard and Mc Donald
Holy See|Heiliger Stuhl (Vatikanstadt)|Status Civitatis Vaticanæ
Honduras|Honduras|Honduras
Hong Kong|Hongkong|Xianggang
Hungary|Ungarn|Magyarorszag
Iceland|Island|Lyoveldio Island
India|Indien|Bharat
Indonesia|Indonesien|Indonesia
Iran (Islamic Republic of)|Iran, Islamische Republik|Iran
Iraq|Irak|Iraq
Ireland|Irland|Éire
Isle of Man|Insel Man|Isle of Man
Israel|Israel|Yisra'el
Italy|Italien|Italia
Jamaica|Jamaika|Jamaica
Japan|Japan|Nippon/Nihon
Jersey|Jersey|Jersey
Jordan|Jordanien|Al Urdun
Kazakhstan|Kasachstan|Qazaqstan
Kenya|Kenya|Kenya
Kiribati|Kiribati|Kiribati, (Kiribas)
Korea, Democratic People's Rep. (North Korea)|Korea, Demokratische Volksrepublik (Nord Korea)|Choson
Korea, Republic of (South Korea)|Korea, Republik (Süd Korea)|Han-guk
Kuwait|Kuwait|Al Kuwayt
Kyrgyzstan|Kirgisistan|Kyrgyz Respublikasy
Lao, People's Democratic Republic|Laos, Demokratische Volksrepublik|Lao
Latvia|Lettland|Latvija
Lebanon|Libanon|Lubnan
Lesotho|Lesotho|Lesotho
Liberia|Liberia|Liberia
Libya|Libyen, Libysch-Arabische Dschamahirija|Libiyah
Liechtenstein|Liechtenstein|Liechtenstein
Lithuania|Litauen|Lietuva
Luxembourg|Luxemburg|Luxembourg, Letzebuerg
Macao|Macau|Aomen
Macedonia, Rep. of|Mazedonien|Makedonija
Madagascar|Madagaskar|Madagascar
Malawi|Malawi|Malawi
Malaysia|Malaysia|Malaysia
Maldives|Malediven|Dhivehi Raajje
Mali|Mali|Mali
Malta|Malta|Malta
Marshall Islands|Marshallinseln|Marshall Islands
Martinique|Martinique|Martinique
Mauritania|Mauretanien|Muritaniyah
Mauritius|Mauritius|Mauritius
Mayotte|Mayotte|Mayotte
Mexico|Mexiko|Estados Unidos Mexicanos
Micronesia, Federal States of|Mikronesien, Föderierte Staaten von|Micronesia
Moldova, Republic of|Moldau, Republik|Moldova
Monaco|Monaco|Monaco
Montenegro|Montenegro|Crna Gora
Mongolia|Mongolei|Mongol Uls
Montserrat|Montserrat|Montserrat
Morocco|Marokko|Al Maghrib
Mozambique|Mosambik|Mocambique
Myanmar, Burma|Myanmar, Birma|Myanma Naingngandaw
Namibia|Namibia|Namibia
Nauru|Nauru|Nauru
Nepal|Nepal|Nepal
Netherlands|Niederlande|Nederland
Netherlands Antilles|Niederländische Antillen|Nederlandse Antillen
New Caledonia|Neukaledonien|Nouvelle-Calédonie
New Zealand|Neuseeland|Aotearoa
Nicaragua|Nicaragua|Nicaragua
Niger|Niger|Niger
Nigeria|Nigeria|Nigeria
Niue|Niue|Niue
Norfolk Island|Norfolkinsel|Norfolk Island
Northern Mariana Islands|Marianen, Nördliche|Northern Mariana Islands
Norway|Norwegen|Norge
Oman|Oman|Saltanat Uman
Pakistan|Pakistan|Pakistan
Palau|Palau|Belau
Palestinian National Authority|Palästinensische Autonomiegebiete|Filastin
Panama|Panama|Panama
Papua New Guinea|Papua-Neuguinea|Papua Niu Gini
Paraguay|Paraguay|Paraguay
Peru|Peru|Peru
Philippines|Philippinen|Pilipinas
Pitcairn Island|Pitcairninseln|Pitcairn Island
Poland|Polen|Polska
Portugal|Portugal|Portugal
Puerto Rico|Puerto Rico|Puerto Rico
Qatar|Katar|Dawlat Qatar
Reunion Island|Réunion|Ile de la Réunion
Romania|Rumänien|Romania
Russian Federation|Russische Föderation (Russland)|Rossiya
Rwanda|Ruanda|Rwanda
Saint Kitts and Nevis|St. Kitts und Nevis| 
Saint Lucia|St. Lucia|Saint Lucia
Saint Vincent and the Grenadines|St. Vincent und die Grenadinen| 
Samoa|Samoa|Samoa
San Marino|San Marino|San Marino
Sao Tome and Príncipe|São Tomé und Príncipe|Sao Tome e Principe
Saudi Arabia|Saudi-Arabien|Al Arabiyah as Suudiyah
Senegal|Senegal|Senegal
Serbia|Serbien|Srbija
Seychelles|Seychellen|Seychelles
Sierra Leone|Sierra Leone|Sierra Leone
Singapore|Singapur|Singapore
Slovakia (Slovak Republic)|Slowakei|Slovensko
Slovenia|Slowenien|Slovenija
Solomon Islands|Salomonen|Solomon Islands
Somalia|Somalia|Somalia
South Africa|Südafrika|South Africa
South Georgia and South Sandwich Islands|Südgeorgien und die südlichen Sandwichinseln| 
Spain|Spanien|España
Sri Lanka|Sri Lanka|Sri Lanka
Saint Helena|St. Helena|Saint Helena
St. Pierre and Miquelon|St. Pierre und Miquelon|Saint-Pierre et Miquelon
Sudan|Sudan|As-Sudan
Suriname|Suriname|Suriname
Svalbard and Jan Mayen Islands|Svalbard und Jan Mayen|Spitzbergen
Swaziland|Swasiland|Swaziland
Sweden|Schweden|Sverige
Switzerland|Schweiz|Schweiz (German), Suisse (French), Svizzera (Italian)
Syria, Syrian Arab Republic|Syrien, Arabische Republik|Suriyah
Taiwan, Republic of China|Taiwan|T'ai-wan
Tajikistan|Tadschikistan|Jumhurii Tojikiston
Tanzania|Tansania, Vereinigte Republik|Tanzania
Thailand|Thailand|Prathet Thai
Tibet|Tibet|Bod
Timor-Leste (East Timor)|Timor-Leste (Osttimor)|Timor
Togo|Togo|Republique Togolaise
Tokelau|Tokelau|Tokelau
Tonga|Tonga|Tonga
Trinidad and Tobago|Trinidad und Tobago|Trinidad, Tobago
Tunisia|Tunesien|Tunis
Turkey|Türkei|Turkiye
Turkmenistan|Turkmenistan|Turkmenistan
Turks and Caicos Islands|Turks- und Caicosinseln|Turks and Caicos Islands
Tuvalu|Tuvalu|Tuvalu
Uganda|Uganda|Uganda
Ukraine|Ukraine|Ukrayina
United Arab Emirates|Vereinigte Arabische Emirate|Al Imarat al Arabiyah al Muttahidah
United Kingdom|Vereinigtes Königreich|United Kingdom
United States|Vereinigte Staaten|United States
U.S. Minor Outlying Islands|Amerikanische Überseeinseln, Kleinere|U.S. Minor Outlying Islands
Uruguay|Uruguay|Republica Oriental del Uruguay
Uzbekistan|Usbekistan|Uzbekiston Respublikasi
Vanuatu|Vanuatu|Vanuatu
Vatican City State (Holy See)|Heiliger Stuhl (Vatikanstadt)|Status Civitatis Vaticanæ
Venezuela|Venezuela|Venezuela
Vietnam|Vietnam|Viet Nam
Virgin Islands (British)|Britische Jungferninseln| 
Virgin Islands (U.S.)|Amerikanische Jungferninseln|Virgin Islands
Wallis and Futuna Islands|Wallis und Futuna|Wallis et Futuna
Western Sahara|Westsahara
Yemen|Jemen|Al Yaman
Zaire (see Congo, Democratic People's Republic)|Zaire|Zaire
Zambia|Sambia|Zambia
Zimbabwe|Simbabwe|Zimbabwe